11111111111111
10000P000000011
10001000C0000111
10001100100001
1000E11C1C0001
1111111111111111
