11111111111111111111111111
1C0000010000000C00000C0001
10010101001000000010000101
10001001000010000000000101
110001001C01C11111111110C1
101000100010000C0000000001
10010001010000000000000001
1E0010001C0001111111111111
1000010001000100010C010001
1C0000000X1000010001000001
11111111111111111111110001
10000C00000000000000000001
1P00000000000000C000000001
11111111111111111111111111