111111
1000E1
100001
1P00C1
111111