111111111111
1E00000000P1
100000000001
1C00000P0001
111111111111