
11111111111111111111111111111
1000E000000000000000000000001
100000000X0000000000000000001
1P0000000000000000X0000000001
1000C00000000000X000000000001
1000000X000X00000000000000001
1000X00000000000X000000000001
11111111111111111111111111111